0000000000
0110001100
0110001100
0000000000
0000440000
0000440000
0000000000
0000000000
0005555555
0000000000
0000000000
0000000000
0000000000
0000000000
0000000000
