9999999999
8888888888
7777777777
6666666666
5555555555
4444444444
3333333333
2222222222
1111111111
0000000000
0000000000
0000000000
0000000000
0000000000
0000000000
